beneiden&lt;beneidete, beneidet&gt; : to envy
genieren : to feel embarrassed
befallen&lt;befell, befallen&gt; : to befall
das Bekenntnis : confession, acknowledgement
die Nuance : nuance
berufstätig : employed, working
stammlen : to stammer
beneiden : to envy, begrudge, covet
neiden : to begrudge sb. sth., to covet sb. sth.
erfordern : to require, to demand
bezeichnen : to mark, label, designate, point out, show
zwingen : to compel, constrain, force, obligate
die Feinheit : elegance, refinement, grace, delicacy
vermeiden : to avoid, evade, didge
die Fähigkeit : ability, qualification, competence
die Heiterkeit : mirth, exhiliration, meriment, cheerfulness
der Imperator : emperor
vertraut : familiar
gering : small
erscheinen : to appear, to seem
erheiten : to cheer, to amuse, to brighten
darstellen : to protrary, to depict, to outline
die Heiterkeit : mirth, gaiety, merriment, cheerfulness, glee
vertraut : familiar
ertönen : to sound, to resonate, to resound
empfindsam : sensitive, sentimental
mit Recht : justifiably
unbedignt : absolute(ly), w/o fail, by all means
das Tonband : audio tape
behandeln : to handle sth., to deal with sth., to be concerned with sth.
ermatten = ermüden : to fatigue, exhaust
ermüdend : fatiguing, tiresome, wearisome, anstrengend
anstecken : to infect so.; to pin sth., at attach sth.
entbehren : to lack, miss, want; to do (or go) without
entbehrlich : non-essential, unnecessary, needless
das Recht : right, claim, power
die Pointe : point, punch line
zittern : to chatter, to dither; to tremble, quake, quiver, shiver
herzshaft : hearty, savoury, lusty
herumsitzen : to sit around (the table); fig. twiddle one's thumbs
die Garderobe, die Garderoben : wardrobe, cloackroom
das Schicksal, die Schicksale : fate, destiny, lot, fortune
der Mörtel : mortar
blass : pallid, colorless
todernst : deadly serious, in dead earnest
unbewegt : deadpan, emotionless, still
je : ever (adj.); every, per (prep.)
die Geschwister : brothers and sisters
