aushalten&lt; hält aus; hielt aus, ausgehalten&gt; : to endure, suffer, bear
der Besitz : possession(s)
die Büchse, die Büchsen : box, case, container
die Schnur, die Schnüre : cord, string, twine
der Stummel, die Stummel : butt, stub (of cigarette, cigar)
aufheben : to take up; pick up; store
der Körper, die Körper : body
wüten : to rage, storm
wütend : furious; irate; mad (auf at)
wertvoll : valuable, precious
ehrenwert : honorable, respectable
ehren : to honor, esteem, pay respect
verachten : to despise, distain
rosa : pink
beziehen : to string (a violin, etc); put clean sheets on; move into
bezogen : upholstered
die Verbindung : connection; bond; alliance
verscheuern : to sell very cheaply
tauschen : to exchange
der Diebstahl, die Diebstähle  : theft
ausgehen : to go out; to go for (walk, etc.); to go places
die Pflicht, die Pflichten : duty, obligation
entgegengehen : go to meet; fig. to approach, face
betrachten : to look at (view); inspect; examine
einig : united;
sich über etwas einig sein : to agree on, over or about sth.
der Begriff (-;-e) : conception, idea, notion; concept, term
hin und wieder : now and then
etwas für richtig halten : to deem sth. right
der Verdacht, die Verdachte : in ~ kommen : suspicion; to be suspected
die Ankunft, die Ankünfte : arrival
wecken : awake;fig. rouse
die Sorge, die Sorgen : care; sorrow; uneasiness, anxiety, concern; alrm
et./jmdn. kommen lassen : to send for so./sth.
zu sich kommen : to come round(gain consciousness); to come to
die Stellung : ,position; job; condition; situation; attitude; rank 
vorziehn : to draw forth; draw(curtains); to prefer, to favor
genußvoll : delightful(ly), appreciative(ly)
hineinschieben; in den Mund ~ : to shove in, to slide smth. into sth; slip a th. into one's mouth
die Narbe, die Narben : scar; pockmark
das Kinn, die Kinne : chin
weiterhin : furthermore; beyond; any longer
beunruhigen : to distrube; trouble; worry
der Anschein, die Anscheins : appearance; look
anscheinend : apparently, seemingly
die Musterung : army physical; medical examination
offenbar : evidently, apparently; public
auffordern : to summon, to prompt; to request smb. to do sth.
die Laufbahn : career; tneure; track, running track
das Zeichen, die Zeichen : sign; token; symbol; mark; badge; indication
unter dem Zeichen von etw. stehen : to be much influenced by sth.
lebhaft : vigorous, vivid, brisk, lively
vorüber : past, over, to be over
 weitergeben : pass on; transmit
aufforderugn : to request, order
die Aufforderugn : call; request; order
vorsichtig : cautious(ly), wary, warily
heruafinden : discover; find out; establish
die Untersuchung : examination; inquiry
heraussuchen : choose, select; pick out
sich finden : to be found; to find onesself
die Kiste, die Kisten : box, chest; case, trunk
die Zange, die Zangen : a pair of tongs
herauskommen : to emerge
das Notizbuch : notebook
das Sparkassenbuch = das Sparbuch : bankbook; savings account
erfreulich : welcome, pleasing, agreeable
die Nelke, die Nelken : carnation
das Gedächtnis, die  Gedächtnisse : memory; remembrance
die Gestalt, die Gestalten : shape, form
anschaffen : to purchase, acquire, buy
die Bretterbude : shack, shed
errichten : to erect, build, raise; found, establish
blühen : to bloom, blossom, flower 
der Erbe, die Erben : heir; successor
angelegen = anliegend : adjacent, adjoining
die Angelegenheit : matter, affair, concern, business
sich et. ausleihen&lt;sich lieh aus, sich ausgeliehen &gt; : to borrow
leihen&lt; lieh, geliehen&gt; : to lend, to loan
verleihen&lt; verlieh, verliehen&gt; : to lend
sich leihen&lt; sich lieh, sich geliehen&gt; : to borrow
