verdanken : to owe
sich verdanken : to be due to
sich bemühen : to attempt, to endeavor, to strive, struggle
vergeben : give away(an Acc.); palce order(with); confer; bestow(on)
einheiraten : to marry into
die Tatsache(-n) : fact
vorsichtig : careful, circumspect
sorgfältig : thorough, careful, meticulous
der Auftrag(äge) : order; job; task; purchase order
die Ausgabe(-n) : expense, outlay; edition (editorial)
abmachen; et. ~ : to arrange, to settle;to agree sth.
ausführen : to implement, to perform, to accomplish, to achieve, to realize
die Gardine(-n) : curtain, drape
zertreten&lt;zertrat, zertreten &gt; : to trample, to scrunch
annehmen : to accept sth., to agree to sth., to suppose, to assume, to believe
erklären : explain; elucidate	
sich zu etwas bereit erklären/bereiterklären : to agree to sth; to be willing to do sth.	
der Rock(Röcke) : skirt; men's jacket
die Nonne(-n) : nun
der Wermut : vermouth
zusammenstellen : to assemble, compile, to lump together; to collocate
berühren : to contact; to refer to sth. briefly; to touch s.o./sth.; to strike a chord with s.o.
der Daumen(-) : thumb
gebrauchen&lt;gebrauchte, gebraucht&gt; : to use, to employ, to exert
das Fabrikat(-e) : make, brand, maufacture
flüstern : to whipser, talk under ones breathe
der Schwerenöter : philanderer,Don Juan
der Anblick(-e) : sight, view, look, spectacle
mager : meager; slender, slim
die Zitrone(-n) : lemon
letze Hand an et. legen : to put the finishing touches on sth.
anlächeln : to smile at
vorkommen : to occur, to seem, to happen, to be found, to happen
der Schrank(Schränke) : cabinet, cupboard, amoire, wardrobe
sich verloben : to become engaged
die Verlobung : engagement, betrothal
dabeisein : to be present
beiseite : aside, apart
vorgehen : to advance, to proceed, to take precedence
das Brustkreuz(-e) : pectoral cross
seufzen : to sigh, groan
der Kleinigkeit(-en) : trife; triviality
schweigen&lt;schwieg, geschwiegen&gt; : to be silent, to keep silent; to hold one's peace
das Butterbrot : bread and butter; piece of bread and butter
nachsehen : to have look-see; to peek; to look after
die Kanne(-n) : pot, jug; can; pitcher
hin(gehen) : to go(to somewhere)
wohin : whereto, where, where...(to)
soviel : as much, that much
gelten/gilt&lt;galt, gegolten&gt; : to apply, to pertain; to hold(remain valid, in force); to be effective; to be worth
empfindlich : sensitive; vulnerable, irritable, testy
abwischen : to wipe, to brush away; to give sth. a wipe
die Linie : line; crease; curve; route
ziehen&lt;zog, gezogen&gt; : to draw; to tug, haul, drag, pull; to strain
auffallen&lt;fiel auf, aufgefallen&gt; : to attract attention, strike; to catch one's one, to be in evidence;jdm. ~ - to occur to sb.
umbinden&lt;band um, umgebunden&gt; : to tie around; to tie sth.
erleuchten : to illuminate; to light sth.; fig. to enlighten
das Freie/im Freien : the open(air); out of doors
senden&lt;sandte, gesandt&gt; : to send; to broadcast, transmit; to mail; to air
der Hausanzug : leisure suit
mehr als je : more than ever
ausgehen : to step out(of the house); to turn out (well); to go out(for a walk)
die Madonna(Madonnen) : Madonna
woher : whencefrom, whence; from where; where...from
verhandeln/die Verhandlung : negotiate; deliberate, confer/negotiations
einschenken : pour out; pour sth. in sth.
eingiessen : ditto
zuschieben : to push towards
verwirren : to confound, bewilder
verwirrt (adj.) : confused
ausgraben : dig out, unearth, exhume; excavate
die Ausgrabung : excavation
durchsehen : to inspect closely, to examine, review
nicht gedeckt sein : to not be covered(bounced check)
der Frauenheld : womanizer
austoßen : to toast
eilen : to split, divide
etwas nicht gewohnt sein : to not be used to sth.
die Kunstliebhaber : art lover
das Bestechungsgeld : bride, kickback
schuldig : guilty, blameworthy
verlassen : to leave
sich auf jemanden verlassen : to rely on someone
wohlabend : well off
