der Gehilfe(-n) :  assistent
die Magd : das Dienstmädchen
betreuen : to supervise, to take care of, to look after (only with things); to look after sb.
sich kümmern um et. :  to see to smth., to take care of sb.
besorgen :  to procure; et. besorgen - to attend to sth., to run errands.
wacklig : rickety
kärglich : scant
großziehen : to bring sb. up, to rear
erziehen : to rear, to educate, to train, to bring up (Kinder). It means "gut großziehen"
der Buchdrucker(-) : book 
imstande (adj) : to be capable, able; zu imstande sein - to be able to...
sich zulegen : to acquire
Seinen : his family
abweisen : to refuse
sich abweisend verhalten : to react negatively; etwas dagegen sein Archaic
veralten : to antiquate, to become obsolete
veraltet : obsolete
eingehen : to arrive; to assume; auf et. eingehen - to agree to sth, to commit o.s. to sth.
auf et. eingehen : to agree to smthg.;et. akzeptieren
nachgeben : to yield, give in
mitunter : every now and them, occasionally, ab und zu
das Begräbnis(-se) : burial, funeral
sich weigern : to refuse; fig. to dig your heels in, to actively resist
ablehnen : to refuse; to turn down, to decline
aufnehmen : to incorporate, to assimilate, to take in (z.B. to your home); to record
aufrecht : upright, erect, upstanding
der Umgang (ä-e) : contact, association; commerce
aufrechthalten : to keep up smth., to perpetuate, to maintain
entnehmen : to extract, to learn from
nichts bringen : to be of no use
auffallen : to attract attention, to be conspicuous
auffällig : conspicuous, eye-catching
aufrechthalten : . Um eine Freundschaft aufrechzuhalten, muß man häufig mit seinen Freuden sprechen.
sich kümmern um : . Wenn usere Eltern alt werden, brauchen sie mehr Hilfe, und ihre Kinder müssen sich um sie kümmern.
aufnehmen : . Sie hatte die schlechte Nachricht nicht gut aufgenommen.
aufnehmen : . Ein Hotel nimmt Gäste auf. Es bringt sie unter.
sich zulegen : . Der reiche Mann hat sich Zeit seines Lebens
zulegen : . Der reiche Mann hat sich Zeit seines Lebems viele Sachen zugelegt.
nichts bringen : . Leider habe ich es als Organisator der Verein zu nichts gebracht.
auffallen : . Ihr buntes Kleid fiel total auf als sie zur Arbeit ging.  
auffallen : . Sein Verhaltn war auffällig.
