gewissenhaft : conscientious, faithful; similar to sorgfälig = careful, meticulous
zuverlässich : reliable, dependable; or to verantwortungsvoll = responsible; or verantwortlich 
nicht übel : not bad
nicht übel verdienen : recht gut verdienen = to make good money
etlich : serveral, a number of; syn: mehr, mehrere, viele
getreu : faithful, trusted; syn: zuverlässig, loyal, sicher
rasend : furious, raging; syn. furios
vertragen | vertrug, vertragen : to stand, to stomach, to tolerate; syn. aushalten - to bear
anmerken : to note, to remark
sich etw. anmerken lassen : to let sth. show, to let on about sth.
eines Tages : idiomatish für: one of these days
eines Sommers : one summer
stet : continuous, constant; syn. steig: steady, continual; daurend: continual(ly)
im Stillen : inwardly, tief in inneren
ausprechen (verb) : to say, to utter, to declare
verlesen/vorlesen : to read aloud
ausgesprochen (adj) : pronounced, markedly; syn. extrem, ganz und gar = altogether, wholly
zärtlich : tender, affectionate
liebenswert : adorable, lovable
verzaubern : to bedazzle, bewitch, enchant
das Plakat : poster, placard; syn Poster
Der Dampfer(-) : steamer, steam boat
schlendern : to stroll, amble, meander; syn. spazieren gehen
der Trotz : defiance
vertiefen : to deepen
sich vertiefen in (Akk.) : to delve into; to immerse o.s. in sth.
sich vertiefen : to engross the mind
Gattin(-nen) : wife, spouse, misses
zu sich finden : to find oneself
dröhnen : to roar, to boom, to drone
tuten : to toot
dreckig : filthy	
das Tau(-e) : rope, cable
hundsföttisch (dated) : low-down, lousy
der Kinn(-e) : chin
haken : hack, cut, chop, cleave(wood)
der Kinnhaken : uppercut to chin (boxing)
hingegen : on the other hand; by contrast
wagen : to dare
zum Mann erzogen : become a man
schätzen : to estimate; to value, to appreciate, to treasure
zuweilen(adj) : occasionally; syn. ab und zu
gestatten : to allow, permit; constent to
herumkommen : to get around; um et. ~ - to avoid smth., to get around smth.
in der Welt herumkommen : die Welt kennenlernen
der Anpruch(ü-e) : claim, right, entitlement;in Anspruch nehmen - to engage (interest, attention)
die Anständigkeit(-en) : decency
die Tropen : tropics
der Helm(-e) : helmut; der Tropenhelm - pith helment
das Eigenheim : one's own house
geraten/gerät&lt;riet, geraten&gt; often ~ in : to get in/into(a situation or mood)
hager : gaunt, haggard
die Tracht(-en) : costume, uniform
der Gürtel : belt
erwähnen : to mention
die Atemzug : breath; breath of air
schmieren : to grease, lubricate, oil
girren : to coo
zögern : to hesitate, to defer; to procrastinate
befremden : to alienate; to appear strange, to cause disconcertment
schreiten &lt;schritt, geschritten&gt; : to stride, to tread
sofern(conj) : provided, in as much as, if
zur Rede stellen : to confront sb., to take sb. to task
schlendern(weak) : to stroll, amble; syn. spazierengehen
hinauf : up, upwards, to the top
zweifeln : to doubt
zweifelhaft : doubtful, dubious, questionable
traut : cozy, intimate
die Heimkehr : home coming
die Heimkehr : home coming; traute Heimkehr - tender homecoming
schwingen&lt;schwang, geschwungen&gt; : to sway, to swing, to brandish, to wield
der Schwung(ü-e) : momentum, drive, impetus, sway; verve, bounce
der Schlagrahm : whipping cream
verspritzen : to spray, to bespatter
berühren : to touch, to contact; to move(emotionally), to concern
der Augenzeuge : eyewitness
gehalten(adj) : held, ketp, upheld
umringen : to surround
gelassen(adj) : calm, serence, composed
erbarmenswürdig : heartrending, pitiable
raten/rät&lt;riet, geraten&gt; : to advise
die Scheidung : separation, divorce, dissolution
tapfer : brave, valliant; syn. mutig
die Reue : remorse, contrition, repentence
abweisen&lt;wies ab, abgewiesen&gt; : to refuse, turn down
die Teilnahme(-n) : interest, concern
ein Eindruck machen auf et. (Akk.) : to make an impression on
<p>
Notes: The use of the subjunctive in the story is mostly Indirekt Rede.
</p>

</div>
<div class="section" id="dative-verbs-list">
### Dative Verbs list
antworten : to answer
befehlen : to command
begegnen : to meet
danken : to thank
dienen : to serve
fehlen : to miss; to be lacking
folgen : to follow
gefallen : to please
gehorchen : to listen, obey
gehören : to belong
gelingen : to succeed
glauben : to believe
helfen : to help (with)
leid tun : to feel sorry, pity
passen : to fit
passieren : to happen
raten : to advise
schmecken : to taste
verziehen : to forgive
wehtun : to hurt 
